****************************************
*..***..***........*...*..........**...*
*..*.....*.....******...*****..........*
*..****..**...............*....****....*
*.....*..*..****..*****...**......*....*
*..****..*..*..**.*...*....*...*.......*
*..*........*....**...*........*...*...*
*......**...*.........*........*...*...*
****************************************
