********************************
*..***..***........*...*......*
*..*.....*.....******...*****..*
*..****..**...............*....*
*.....*..*..****..*****...**...*
*..****..*..*..*..*...*....*...*
*..*........*....**...*........*
*......**...*.........*........*
********************************
