*********************************************************************
*...................................................................*
*...................................................................*
*......*.....****.............****............****.....**...........*
*.....*..............................................******.........*
*......*.............****..............****............**...........*
*...................................................................*
*...................................................................*
*********************************************************************