****************************************
*..***..***........*...*..........**...*
*..*.....**....******...*****..........*
*..****...*...............*....****....*
*.....*.....****..*****...**......*....*
*..****.....*..**.*...*....*...*.......*
*..**.......*....**...*........*...*...*
*.......**..*.........*........*...*...*
****************************************