****************
*........**....*
*..*...........*
*..............*
*..............*
*..............*
*..............*
*...*.....*....*
*..............*
*..............*
*.......**.....*
*..............*
*...*..........*
*..............*
*..........*...*
*..........*...*
*..............*
****************