***********************************************
*..****...*...............*...*...........*...*
*..*.......*.....***....***...*****...***.*...*
*..****...*........*.............*....*...*...*
*.....*............***...*****...**...*****...*
*..****.....**...............*....*...........*
*..*.....**.......********...*........*...*...*
*..***...*........*..........****.....*...*...*
*....*****....*......**....*..................*
*.............*...*........*..................*
***********************************************