*******************
*.................*
*..*.....**.......*
*.................*
*.................*
*.................*
*.................*
*...*.........*...*
*.................*
*.................*
*.......**........*
*.................*
*...*.............*
*.................*
*..........*......*
*..........*......*
*.................*
*******************