***********************************************
*..****...*...............*...................*
*..*.......*.....***......*...**......*...*...*
*.............................................*
*...................**...........**...*****...*
*..*........**...............*....*...........*
*..*.....*........**...**............*....*...*
*..*..............*............**.....*..*....*
*....**.......*............*..................*
*.............*............*..................*
***********************************************